11111111111
1.O.H...H.1
1..O...H..1
1....O.O.H1
1H.O..R...1
1...T...O.1
1.H..O..H.1
1..HH..O..1
1.O..H..O.1
1...HH..H.1
11111111111