11111111111
1...H.....1
1......H..1
1.H.......1
1.....R...1
1...T.....1
1.........1
1.........1
1.....H...1
1.........1
11111111111