11111111111
1...H...H.1
1......H..1
1........H1
1H....R...1
1...T.....1
1.H.....H.1
1..HH...H.1
1....HH...1
1..HH...H.1
11111111111