111111111111
1..HH...HR.1
1..RO.O..H.1
1HH..RH.O.R1
1HRO...R..H1
1...TO.HH..1
1..H..O....1
1.O.RH..O.R1
1.HH.O...HH1
1.RO.R.O...1
1...HHH..HD1
111111111111