111111111111
1..HH...H..1
1...O.O..H.1
1HH...H.O..1
1H.O..R...H1
1...TO.HH..1
1..H..O....1
1.O..H..O..1
1.HH.O...HH1
1..O...O...1
1...HHH..H.1
111111111111